serpents - змії
ruthless - безжалісний
absolution - виправдання(помилування)
burden - тягар
jetty - пристань
breastfeed - годувати грудьми
incursions - вторгнення
Blasphemous - Богохульство
wrath - гінв
adopting - прийняття
imprecise - неточний
Sacrilege - святиня(святотатство, богохульство)
Impunity - безкарність
jeopardy - небезпека (danger of loss)
complicit - співучасник
inevitable - неминучі
fickle - непостійний
shepherd - пастир
virtue - чеснота, доброчесність
humility - смирення
intimidated - залякані
despoiled - зруйновані
Scourge - батіг
prostrate - розпростертими (руками)
interleaving - перемежування(прошарування)
beware - будьте обережні
dereliction - нерозуміння
sundering - розкрадання
lambs - ягнят
vanity - марнославство
humble - скромний
reconcile - примирити
crucified - розп'ятий
struggle - боротьба
comprehend - зрозуміти
reindeer - північний олень
sac - мішок
prevailing - діючий ( переважає )
arse - дупа
precisely - точно
emissaries - висланець
cynical - цинічний
quarrel - сварка
witan - an assembly of higher ecclesiastics and important laymen
imperative - something that is extremely important and must be done
depredations - вторгнення,грабіж; the act or an instance of plundering; robbery; pillage
sorrow - смуток; a feeling of deep sadness or regret.
ached - хворіти; feel a steady, fairly strong pain.
sippin - попивати; to drink (a liquid) a little at a time
venom - яд тварини,злість; the poisonous fluid that some animals, as certain snakes and spiders, secrete and introduce into the bodies of their victims by biting, stinging, etc.
vibe - атмосфера
fall out - випадати, сваритися;
confine -обмежувати; to restrict
lead - вести, свинець
flavour - смак(вкус), аромат;
despise - призирати 
(get | catch | bring) up to speed - вводити в курс справи
wrapped - охоплений, загорнутий
heartache - душевний біль; feelings of great sadness
cast away - викидати, ізгой; to get rid of someone or something:
cutthroat - беспощадно, головоріз; not involving considering or worrying about any harm caused to others:
fading - затухати; to (cause to) lose colour, brightness, or strength gradually:
fable - казка; a short story that tells a general truth or is only partly based on fact
belly - живіт; al the stomach or the front part of the body between your chest and your legs
behead - обезголовлювати; to cut off someone's head, especially as a punishment
by all means(surely) - неодмінно, безсумнівно; without hesitation or doubt
remiss - допускати оплошность,недбайливий, пренебрягающий ;careless and not doing a duty well enough:
worship - поклонятися, боготворити; to have or show a strong feeling of respect and admiration for God or a god:
consummate - доводити до кінця;to make something complete or perfect
fervent - 
hollow - порожнеча
Witan - an assembly of higher ecclesiastics and important laymen, including king
gut - кишка, потрошити;
entrails - нутрощі;
rejoicing - радість, свято;
determination - визначення;
invoking - виклик, заклик;
vanished - Зниклий;
perpetuity - вічність, назавжди;
remorse - жаль, каяття;
matrimonial - шлюбний;
inquiries - запити;
plotted - побудований, замишляти змову;
grieve - смуток;
startle - здригатися, лякати;
ascendancy
rectified - виправлено;to correct something or make something right:
Vomiting - блювота;  to empty the contents of the stomach through the mouth
reciprocate - відповідати взаємністю
carnage - різанина
disguise - маскування
resignation -відставка
missile's - ракети
condescend - поблажливий
Beleaguered - Обезпоряджений, переслідуванийж
stateside - державна;
briefed - інструктаж;
narrow - вузький;
vivid - яскраві, чіткі;
intimidated - заляканий;
infiltrating - проникнення;
Pursue - Переслідувати;
precious - дорогоцінний;
transparency - прозорість;
ledger - головна книга;a book or other collection of financial accounts.
Desperate - Відчайдушні;
prompt - підказка;
celestial - небесний, божий;
abhor - огида, ненавість;
Resilient - Пружний, еластичний;
contagious - заразний;
eradicate - викорінювати;
deception - обман;
carpet - килим;
Inception - Початок;
leap - стрибок;
maze - лабіринт;
converge - сходяться;
sedative - заспокійливий засіб;
porch - ганок;
transgressed - переступив, порушувати;
inevitable - неминучий;
prosecution - переслідування;
splendid - чудовий, прекрасний;
Enunciate - Виголошувати;
swallowed - ковтнув;
Indenture - Відступ;
servitude - залежність, неволя;
herrings - оселедці;
regal - царський, королівський;
stammer - заїка;
infatuated - розлючений;
credentials - повноваження;
resignation - відставка;
susceptible - сприйнятливий;
albeit - хоча;
recess - поглиблення, канікули;
Demerits - вада;
Factotum - майстер на всі руки, довірена персона;
rhyme - рима;
encore - на біс;
stung - укушений, вжалений;
mediocrity- посередність, звичайна людина;
ambush - засідка;
den - гніздо, берліг;
precaution - обережність;
inevitable - неминучий;
indelicate - відзначати;
hard-soled - тверда підошва;
unbearable - нестерпний;
Orient - Схід;
comprehend - осмислити;
Fudge - вигадка, брехня;
abundance - безліч, достатньо;
conscience - совість, свідомість;
chancellor - chancellor;
ambassadors - посли;
elusive - невловимий;
banished - вигнали;
bargain - торгуватися;
swindled - обдурений;
vergence - вірність;
defy - протистояти;
arrogant - зарозумілий;
erased - стерти;
vicious - порочний;
treaty - договір;
jammed - застряг;
shroud - плащаницю, ховатись;
exile - заслання;
Premonitions - Передчуття;
Henceforth - Відтепер;
allegiance - вірність;
apprehended - затримано;
breach - порушення;
Blackmail - Шантаж;
sewer - каналізація;
putrid - гнилий;
Millennium - Тисячоліття;
Falcon - Сокіл;
relentless - невблаганна;
alderman - правитель;
mortified - замурований, умертвенний;
swamp - болото;
Roach - Плотва;
sobriquet - тверезий, кличка;
condolences - співчуття;
cloak - плащ;